#########
#–––––––#
#.––O–––#
#–––––––#
#–––.–––#
#–X––––.#
#–XX––––#
#–––S–––#
#########