––––#####––––––––––
––––#–––#––––––––––
––––#X––#––––––––––
––###––X##–––––––––
––#––X–X–#–––––––––
###–#–##–#–––######
#–––#–##–#####––..#
#–X––X––––––––––..#
#####–###–#S##––..#
––––#–––––#########
––––#######––––––––