–#####–––
–#---####
–#---#--#
–##----.#
###–###.#
#–x–#–#.#
#–xx#–###
#S––#––––
#####––––