–#####–––
–#–––####
–#–––#––#
–##––––.#
###–###.#
#–X–#–#.#
#–XX#–###
#S––#––––
#####––––