–#####–––
–#–––####
–#–––#––#
–##––––.#
###–###.#
#–x–#–#.#
#–xx#–###
#S––#––––
#####––––