#########
#–––––––#
#.––O–––#
#–––––––#
#–––.–––#
#–x––––.#
#–xx––––#
#–––S–––#
#########